# channel y	y	x	x	x	x	x	x	x	x	y	y	y	y	y y y y y
APVid:	  0	1	2	3	4	5	6	7	8	9	10	11	-1	-1	-1  -1	-1 -1
Chamber:  TRK0	TRK0	TRK1	TRK2	None	TEST0	TEST1	TEST2	TRK3	TRK4	TRK5	TRK5	None	None	None	None None None
0	  0	128	0	0	0	0	0	0	0	0	0	128	0	0	0	0    0	  0
1	  1	129	1	1	1	1	1	1	1	1	1	129	1	1	1	1    1	  1
2	  2	130	2	2	2	2	2	2	2	2	2	130	2	2	2	2    2	  2
3	  3	131	3	3	3	3	3	3	3	3	3	131	3	3	3	3    3	  3
4	  4	132	4	4	4	4	4	4	4	4	4	132	4	4	4	4    4	  4
5	  5	133	5	5	5	5	5	5	5	5	5	133	5	5	5	5    5	  5
6	  6	134	6	6	6	6	6	6	6	6	6	134	6	6	6	6    6	  6
7	  7	135	7	7	7	7	7	7	7	7	7	135	7	7	7	7    7	  7
8	  8	136	8	8	8	8	8	8	8	8	8	136	8	8	8	8    8	  8
9	  9	137	9	9	9	9	9	9	9	9	9	137	9	9	9	9    9	  9
10	  10	138	10	10	10	10	10	10	10	10	10	138	10	10	10	10   10	  10
11	  11	139	11	11	11	11	11	11	11	11	11	139	11	11	11	11   11	  11
12	  12	140	12	12	12	12	12	12	12	12	12	140	12	12	12	12   12	  12
13	  13	141	13	13	13	13	13	13	13	13	13	141	13	13	13	13   13	  13
14	  14	142	14	14	14	14	14	14	14	14	14	142	14	14	14	14   14	  14
15	  15	143	15	15	15	15	15	15	15	15	15	143	15	15	15	15   15	  15
16	  16	144	16	16	16	16	16	16	16	16	16	144	16	16	16	16   16	  16
17	  17	145	17	17	17	17	17	17	17	17	17	145	17	17	17	17   17	  17
18	  18	146	18	18	18	18	18	18	18	18	18	146	18	18	18	18   18	  18
19	  19	147	19	19	19	19	19	19	19	19	19	147	19	19	19	19   19	  19
20	  20	148	20	20	20	20	20	20	20	20	20	148	20	20	20	20   20	  20
21	  21	149	21	21	21	21	21	21	21	21	21	149	21	21	21	21   21	  21
22	  22	150	22	22	22	22	22	22	22	22	22	150	22	22	22	22   22	  22
23	  23	151	23	23	23	23	23	23	23	23	23	151	23	23	23	23   23	  23
24	  24	152	24	24	24	24	24	24	24	24	24	152	24	24	24	24   24	  24
25	  25	153	25	25	25	25	25	25	25	25	25	153	25	25	25	25   25	  25
26	  26	154	26	26	26	26	26	26	26	26	26	154	26	26	26	26   26	  26
27	  27	155	27	27	27	27	27	27	27	27	27	155	27	27	27	27   27	  27
28	  28	156	28	28	28	28	28	28	28	28	28	156	28	28	28	28   28	  28
29	  29	157	29	29	29	29	29	29	29	29	29	157	29	29	29	29   29	  29
30	  30	158	30	30	30	30	30	30	30	30	30	158	30	30	30	30   30	  30
31	  31	159	31	31	31	31	31	31	31	31	31	159	31	31	31	31   31	  31
32	  32	160	32	32	32	32	32	32	32	32	32	160	32	32	32	32   32	  32
33	  33	161	33	33	33	33	33	33	33	33	33	161	33	33	33	33   33	  33
34	  34	162	34	34	34	34	34	34	34	34	34	162	34	34	34	34   34	  34
35	  35	163	35	35	35	35	35	35	35	35	35	163	35	35	35	35   35	  35
36	  36	164	36	36	36	36	36	36	36	36	36	164	36	36	36	36   36	  36
37	  37	165	37	37	37	37	37	37	37	37	37	165	37	37	37	37   37	  37
38	  38	166	38	38	38	38	38	38	38	38	38	166	38	38	38	38   38	  38
39	  39	167	39	39	39	39	39	39	39	39	39	167	39	39	39	39   39	  39
40	  40	168	40	40	40	40	40	40	40	40	40	168	40	40	40	40   40	  40
41	  41	169	41	41	41	41	41	41	41	41	41	169	41	41	41	41   41	  41
42	  42	170	42	42	42	42	42	42	42	42	42	170	42	42	42	42   42	  42
43	  43	171	43	43	43	43	43	43	43	43	43	171	43	43	43	43   43	  43
44	  44	172	44	44	44	44	44	44	44	44	44	172	44	44	44	44   44	  44
45	  45	173	45	45	45	45	45	45	45	45	45	173	45	45	45	45   45	  45
46	  46	174	46	46	46	46	46	46	46	46	46	174	46	46	46	46   46	  46
47	  47	175	47	47	47	47	47	47	47	47	47	175	47	47	47	47   47	  47
48	  48	176	48	48	48	48	48	48	48	48	48	176	48	48	48	48   48	  48
49	  49	177	49	49	49	49	49	49	49	49	49	177	49	49	49	49   49	  49
50	  50	178	50	50	50	50	50	50	50	50	50	178	50	50	50	50   50	  50
51	  51	179	51	51	51	51	51	51	51	51	51	179	51	51	51	51   51	  51
52	  52	180	52	52	52	52	52	52	52	52	52	180	52	52	52	52   52	  52
53	  53	181	53	53	53	53	53	53	53	53	53	181	53	53	53	53   53	  53
54	  54	182	54	54	54	54	54	54	54	54	54	182	54	54	54	54   54	  54
55	  55	183	55	55	55	55	55	55	55	55	55	183	55	55	55	55   55	  55
56	  56	184	56	56	56	56	56	56	56	56	56	184	56	56	56	56   56	  56
57	  57	185	57	57	57	57	57	57	57	57	57	185	57	57	57	57   57	  57
58	  58	186	58	58	58	58	58	58	58	58	58	186	58	58	58	58   58	  58
59	  59	187	59	59	59	59	59	59	59	59	59	187	59	59	59	59   59	  59
60	  60	188	60	60	60	60	60	60	60	60	60	188	60	60	60	60   60	  60
61	  61	189	61	61	61	61	61	61	61	61	61	189	61	61	61	61   61	  61
62	  62	190	62	62	62	62	62	62	62	62	62	190	62	62	62	62   62	  62
63	  63	191	63	63	63	63	63	63	63	63	63	191	63	63	63	63   63	  63
64	  64	192	64	64	64	64	64	64	64	64	64	192	64	64	64	64   64	  64
65	  65	193	65	65	65	65	65	65	65	65	65	193	65	65	65	65   65	  65
66	  66	194	66	66	66	66	66	66	66	66	66	194	66	66	66	66   66	  66
67	  67	195	67	67	67	67	67	67	67	67	67	195	67	67	67	67   67	  67
68	  68	196	68	68	68	68	68	68	68	68	68	196	68	68	68	68   68	  68
69	  69	197	69	69	69	69	69	69	69	69	69	197	69	69	69	69   69	  69
70	  70	198	70	70	70	70	70	70	70	70	70	198	70	70	70	70   70	  70
71	  71	199	71	71	71	71	71	71	71	71	71	199	71	71	71	71   71	  71
72	  72	200	72	72	72	72	72	72	72	72	72	200	72	72	72	72   72	  72
73	  73	201	73	73	73	73	73	73	73	73	73	201	73	73	73	73   73	  73
74	  74	202	74	74	74	74	74	74	74	74	74	202	74	74	74	74   74	  74
75	  75	203	75	75	75	75	75	75	75	75	75	203	75	75	75	75   75	  75
76	  76	204	76	76	76	76	76	76	76	76	76	204	76	76	76	76   76	  76
77	  77	205	77	77	77	77	77	77	77	77	77	205	77	77	77	77   77	  77
78	  78	206	78	78	78	78	78	78	78	78	78	206	78	78	78	78   78	  78
79	  79	207	79	79	79	79	79	79	79	79	79	207	79	79	79	79   79	  79
80	  80	208	80	80	80	80	80	80	80	80	80	208	80	80	80	80   80	  80
81	  81	209	81	81	81	81	81	81	81	81	81	209	81	81	81	81   81	  81
82	  82	210	82	82	82	82	82	82	82	82	82	210	82	82	82	82   82	  82
83	  83	211	83	83	83	83	83	83	83	83	83	211	83	83	83	83   83	  83
84	  84	212	84	84	84	84	84	84	84	84	84	212	84	84	84	84   84	  84
85	  85	213	85	85	85	85	85	85	85	85	85	213	85	85	85	85   85	  85
86	  86	214	86	86	86	86	86	86	86	86	86	214	86	86	86	86   86	  86
87	  87	215	87	87	87	87	87	87	87	87	87	215	87	87	87	87   87	  87
88	  88	216	88	88	88	88	88	88	88	88	88	216	88	88	88	88   88	  88
89	  89	217	89	89	89	89	89	89	89	89	89	217	89	89	89	89   89	  89
90	  90	218	90	90	90	90	90	90	90	90	90	218	90	90	90	90   90	  90
91	  91	219	91	91	91	91	91	91	91	91	91	219	91	91	91	91   91	  91
92	  92	220	92	92	92	92	92	92	92	92	92	220	92	92	92	92   92	  92
93	  93	221	93	93	93	93	93	93	93	93	93	221	93	93	93	93   93	  93
94	  94	222	94	94	94	94	94	94	94	94	94	222	94	94	94	94   94	  94
95	  95	223	95	95	95	95	95	95	95	95	95	223	95	95	95	95   95	  95
96	  96	224	96	96	96	96	96	96	96	96	96	224	96	96	96	96   96	  96
97	  97	225	97	97	97	97	97	97	97	97	97	225	97	97	97	97   97	  97
98	  98	226	98	98	98	98	98	98	98	98	98	226	98	98	98	98   98	  98
99	  99	227	99	99	99	99	99	99	99	99	99	227	99	99	99	99   99	  99
100	  100	228	100	100	100	100	100	100	100	100	100	228	100	100	100	100  100  100
101	  101	229	101	101	101	101	101	101	101	101	101	229	101	101	101	101  101  101
102	  102	230	102	102	102	102	102	102	102	102	102	230	102	102	102	102  102  102
103	  103	231	103	103	103	103	103	103	103	103	103	231	103	103	103	103  103  103
104	  104	232	104	104	104	104	104	104	104	104	104	232	104	104	104	104  104  104
105	  105	233	105	105	105	105	105	105	105	105	105	233	105	105	105	105  105  105
106	  106	234	106	106	106	106	106	106	106	106	106	234	106	106	106	106  106  106
107	  107	235	107	107	107	107	107	107	107	107	107	235	107	107	107	107  107  107
108	  108	236	108	108	108	108	108	108	108	108	108	236	108	108	108	108  108  108
109	  109	237	109	109	109	109	109	109	109	109	109	237	109	109	109	109  109  109
110	  110	238	110	110	110	110	110	110	110	110	110	238	110	110	110	110  110  110
111	  111	239	111	111	111	111	111	111	111	111	111	239	111	111	111	111  111  111
112	  112	240	112	112	112	112	112	112	112	112	112	240	112	112	112	112  112  112
113	  113	241	113	113	113	113	113	113	113	113	113	241	113	113	113	113  113  113
114	  114	242	114	114	114	114	114	114	114	114	114	242	114	114	114	114  114  114
115	  115	243	115	115	115	115	115	115	115	115	115	243	115	115	115	115  115  115
116	  116	244	116	116	116	116	116	116	116	116	116	244	116	116	116	116  116  116
117	  117	245	117	117	117	117	117	117	117	117	117	245	117	117	117	117  117  117
118	  118	246	118	118	118	118	118	118	118	118	118	246	118	118	118	118  118  118
119	  119	247	119	119	119	119	119	119	119	119	119	247	119	119	119	119  119  119
120	  120	248	120	120	120	120	120	120	120	120	120	248	120	120	120	120  120  120
121	  121	249	121	121	121	121	121	121	121	121	121	249	121	121	121	121  121  121
122	  122	250	122	122	122	122	122	122	122	122	122	250	122	122	122	122  122  122
123	  123	251	123	123	123	123	123	123	123	123	123	251	123	123	123	123  123  123
124	  124	252	124	124	124	124	124	124	124	124	124	252	124	124	124	124  124  124
125	  125	253	125	125	125	125	125	125	125	125	125	253	125	125	125	125  125  125
126	  126	254	126	126	126	126	126	126	126	126	126	254	126	126	126	126  126  126
127	  127	255	127	127	127	127	127	127	127	127	127	255	127	127	127	127  127  127