# mapping files for BES3 beam test																		
# version Nov.-Dec. 2014 for Test beam in H4																		
# version 1.0																		
# channel y	y	y	y	y	y	y	y	x	x	x	x	x	x	x				
APVid:	0	-1	2	3	4	-1	6	-1	-1	-1	10	11	12	-1	-1	-1	-1	-1
Chamber: TRK0	TRK0	TRK1	TRK1	TRK2	TRK2	TRK4	TRK4	TRK0	TRK1	TRK2	TRK4	TRK0	TRK1 	RM3	RM3	RM3	RM3
0	63	0	0	0	0	0	0	0	0	0	0	0	0	0	0	0	0	0
1	127	1	1	1	1	1	1	1	1	1	1	1	1	1	1	1	1	1
2	62	2	2	2	2	2	2	2	2	2	2	2	2	2	2	2	2	2
3	126	3	3	3	3	3	3	3	3	3	3	3	3	3	3	3	3	3
4	61	4	4	4	4	4	4	4	4	4	4	4	4	4	4	4	4	4
5	125	5	5	5	5	5	5	5	5	5	5	5	5	5	5	5	5	5
6	60	6	6	6	6	6	6	6	6	6	6	6	6	6	6	6	6	6
7	124	7	7	7	7	7	7	7	7	7	7	7	7	7	7	7	7	7
8	59	8	8	8	8	8	8	8	8	8	8	8	8	8	8	8	8	8
9	123	9	9	9	9	9	9	9	9	9	9	9	9	9	9	9	9	9
10	58	10	10	10	10	10	10	10	10	10	10	10	10	10	10	10	10	10
11	122	11	11	11	11	11	11	11	11	11	11	11	11	11	11	11	11	11
12	57	12	12	12	12	12	12	12	12	12	12	12	12	12	12	12	12	12
13	121	13	13	13	13	13	13	13	13	13	13	13	13	13	13	13	13	13
14	56	14	14	14	14	14	14	14	14	14	14	14	14	14	14	14	14	14
15	120	15	15	15	15	15	15	15	15	15	15	15	15	15	15	15	15	15
16	55	16	16	16	16	16	16	16	16	16	16	16	16	16	16	16	16	16
17	119	17	17	17	17	17	17	17	17	17	17	17	17	17	17	17	17	17
18	54	18	18	18	18	18	18	18	18	18	18	18	18	18	18	18	18	18
19	118	19	19	19	19	19	19	19	19	19	19	19	19	19	19	19	19	19
20	53	20	20	20	20	20	20	20	20	20	20	20	20	20	20	20	20	20
21	117	21	21	21	21	21	21	21	21	21	21	21	21	21	21	21	21	21
22	52	22	22	22	22	22	22	22	22	22	22	22	22	22	22	22	22	22
23	116	23	23	23	23	23	23	23	23	23	23	23	23	23	23	23	23	23
24	51	24	24	24	24	24	24	24	24	24	24	24	24	24	24	24	24	24
25	115	25	25	25	25	25	25	25	25	25	25	25	25	25	25	25	25	25
26	50	26	26	26	26	26	26	26	26	26	26	26	26	26	26	26	26	26
27	114	27	27	27	27	27	27	27	27	27	27	27	27	27	27	27	27	27
28	49	28	28	28	28	28	28	28	28	28	28	28	28	28	28	28	28	28
29	113	29	29	29	29	29	29	29	29	29	29	29	29	29	29	29	29	29
30	48	30	30	30	30	30	30	30	30	30	30	30	30	30	30	30	30	30
31	112	31	31	31	31	31	31	31	31	31	31	31	31	31	31	31	31	31
32	47	32	32	32	32	32	32	32	32	32	32	32	32	32	32	32	32	32
33	111	33	33	33	33	33	33	33	33	33	33	33	33	33	33	33	33	33
34	46	34	34	34	34	34	34	34	34	34	34	34	34	34	34	34	34	34
35	110	35	35	35	35	35	35	35	35	35	35	35	35	35	35	35	35	35
36	45	36	36	36	36	36	36	36	36	36	36	36	36	36	36	36	36	36
37	109	37	37	37	37	37	37	37	37	37	37	37	37	37	37	37	37	37
38	44	38	38	38	38	38	38	38	38	38	38	38	38	38	38	38	38	38
39	108	39	39	39	39	39	39	39	39	39	39	39	39	39	39	39	39	39
40	43	40	40	40	40	40	40	40	40	40	40	40	40	40	40	40	40	40
41	107	41	41	41	41	41	41	41	41	41	41	41	41	41	41	41	41	41
42	42	42	42	42	42	42	42	42	42	42	42	42	42	42	42	42	42	42
43	106	43	43	43	43	43	43	43	43	43	43	43	43	43	43	43	43	43
44	41	44	44	44	44	44	44	44	44	44	44	44	44	44	44	44	44	44
45	105	45	45	45	45	45	45	45	45	45	45	45	45	45	45	45	45	45
46	40	46	46	46	46	46	46	46	46	46	46	46	46	46	46	46	46	46
47	104	47	47	47	47	47	47	47	47	47	47	47	47	47	47	47	47	47
48	39	48	48	48	48	48	48	48	48	48	48	48	48	48	48	48	48	48
49	103	49	49	49	49	49	49	49	49	49	49	49	49	49	49	49	49	49
50	38	50	50	50	50	50	50	50	50	50	50	50	50	50	50	50	50	50
51	102	51	51	51	51	51	51	51	51	51	51	51	51	51	51	51	51	51
52	37	52	52	52	52	52	52	52	52	52	52	52	52	52	52	52	52	52
53	101	53	53	53	53	53	53	53	53	53	53	53	53	53	53	53	53	53
54	36	54	54	54	54	54	54	54	54	54	54	54	54	54	54	54	54	54
55	100	55	55	55	55	55	55	55	55	55	55	55	55	55	55	55	55	55
56	35	56	56	56	56	56	56	56	56	56	56	56	56	56	56	56	56	56
57	99	57	57	57	57	57	57	57	57	57	57	57	57	57	57	57	57	57
58	34	58	58	58	58	58	58	58	58	58	58	58	58	58	58	58	58	58
59	98	59	59	59	59	59	59	59	59	59	59	59	59	59	59	59	59	59
60	33	60	60	60	60	60	60	60	60	60	60	60	60	60	60	60	60	60
61	97	61	61	61	61	61	61	61	61	61	61	61	61	61	61	61	61	61
62	32	62	62	62	62	62	62	62	62	62	62	62	62	62	62	62	62	62
63	96	63	63	63	63	63	63	63	63	63	63	63	63	63	63	63	63	63
64	31	64	64	64	64	64	64	64	64	64	64	64	64	64	64	64	64	64
65	95	65	65	65	65	65	65	65	65	65	65	65	65	65	65	65	65	65
66	30	66	66	66	66	66	66	66	66	66	66	66	66	66	66	66	66	66
67	94	67	67	67	67	67	67	67	67	67	67	67	67	67	67	67	67	67
68	29	68	68	68	68	68	68	68	68	68	68	68	68	68	68	68	68	68
69	93	69	69	69	69	69	69	69	69	69	69	69	69	69	69	69	69	69
70	28	70	70	70	70	70	70	70	70	70	70	70	70	70	70	70	70	70
71	92	71	71	71	71	71	71	71	71	71	71	71	71	71	71	71	71	71
72	27	72	72	72	72	72	72	72	72	72	72	72	72	72	72	72	72	72
73	91	73	73	73	73	73	73	73	73	73	73	73	73	73	73	73	73	73
74	26	74	74	74	74	74	74	74	74	74	74	74	74	74	74	74	74	74
75	90	75	75	75	75	75	75	75	75	75	75	75	75	75	75	75	75	75
76	25	76	76	76	76	76	76	76	76	76	76	76	76	76	76	76	76	76
77	89	77	77	77	77	77	77	77	77	77	77	77	77	77	77	77	77	77
78	24	78	78	78	78	78	78	78	78	78	78	78	78	78	78	78	78	78
79	88	79	79	79	79	79	79	79	79	79	79	79	79	79	79	79	79	79
80	23	80	80	80	80	80	80	80	80	80	80	80	80	80	80	80	80	80
81	87	81	81	81	81	81	81	81	81	81	81	81	81	81	81	81	81	81
82	22	82	82	82	82	82	82	82	82	82	82	82	82	82	82	82	82	82
83	86	83	83	83	83	83	83	83	83	83	83	83	83	83	83	83	83	83
84	21	84	84	84	84	84	84	84	84	84	84	84	84	84	84	84	84	84
85	85	85	85	85	85	85	85	85	85	85	85	85	85	85	85	85	85	85
86	20	86	86	86	86	86	86	86	86	86	86	86	86	86	86	86	86	86
87	84	87	87	87	87	87	87	87	87	87	87	87	87	87	87	87	87	87
88	19	88	88	88	88	88	88	88	88	88	88	88	88	88	88	88	88	88
89	83	89	89	89	89	89	89	89	89	89	89	89	89	89	89	89	89	89
90	18	90	90	90	90	90	90	90	90	90	90	90	90	90	90	90	90	90
91	82	91	91	91	91	91	91	91	91	91	91	91	91	91	91	91	91	91
92	17	92	92	92	92	92	92	92	92	92	92	92	92	92	92	92	92	92
93	81	93	93	93	93	93	93	93	93	93	93	93	93	93	93	93	93	93
94	16	94	94	94	94	94	94	94	94	94	94	94	94	94	94	94	94	94
95	80	95	95	95	95	95	95	95	95	95	95	95	95	95	95	95	95	95
96	15	96	96	96	96	96	96	96	96	96	96	96	96	96	96	96	96	96
97	79	97	97	97	97	97	97	97	97	97	97	97	97	97	97	97	97	97
98	14	98	98	98	98	98	98	98	98	98	98	98	98	98	98	98	98	98
99	78	99	99	99	99	99	99	99	99	99	99	99	99	99	99	99	99	99
100	13	100	100	100	100	100	100	100	100	100	100	100	100	100	100	100	100	100
101	77	101	101	101	101	101	101	101	101	101	101	101	101	101	101	101	101	101
102	12	102	102	102	102	102	102	102	102	102	102	102	102	102	102	102	102	102
103	76	103	103	103	103	103	103	103	103	103	103	103	103	103	103	103	103	103
104	11	104	104	104	104	104	104	104	104	104	104	104	104	104	104	104	104	104
105	75	105	105	105	105	105	105	105	105	105	105	105	105	105	105	105	105	105
106	10	106	106	106	106	106	106	106	106	106	106	106	106	106	106	106	106	106
107	74	107	107	107	107	107	107	107	107	107	107	107	107	107	107	107	107	107
108	9	108	108	108	108	108	108	108	108	108	108	108	108	108	108	108	108	108
109	73	109	109	109	109	109	109	109	109	109	109	109	109	109	109	109	109	109
110	8	110	110	110	110	110	110	110	110	110	110	110	110	110	110	110	110	110
111	72	111	111	111	111	111	111	111	111	111	111	111	111	111	111	111	111	111
112	7	112	112	112	112	112	112	112	112	112	112	112	112	112	112	112	112	112
113	71	113	113	113	113	113	113	113	113	113	113	113	113	113	113	113	113	113
114	6	114	114	114	114	114	114	114	114	114	114	114	114	114	114	114	114	114
115	70	115	115	115	115	115	115	115	115	115	115	115	115	115	115	115	115	115
116	5	116	116	116	116	116	116	116	116	116	116	116	116	116	116	116	116	116
117	69	117	117	117	117	117	117	117	117	117	117	117	117	117	117	117	117	117
118	4	118	118	118	118	118	118	118	118	118	118	118	118	118	118	118	118	118
119	68	119	119	119	119	119	119	119	119	119	119	119	119	119	119	119	119	119
120	3	120	120	120	120	120	120	120	120	120	120	120	120	120	120	120	120	120
121	67	121	121	121	121	121	121	121	121	121	121	121	121	121	121	121	121	121
122	2	122	122	122	122	122	122	122	122	122	122	122	122	122	122	122	122	122
123	66	123	123	123	123	123	123	123	123	123	123	123	123	123	123	123	123	123
124	1	124	124	124	124	124	124	124	124	124	124	124	124	124	124	124	124	124
125	65	125	125	125	125	125	125	125	125	125	125	125	125	125	125	125	125	125
126	0	126	126	126	126	126	126	126	126	126	126	126	126	126	126	126	126	126
127	64	127	127	127	127	127	127	127	127	127	127	127	127	127	127	127	127	127
