# channel y	x	y	x	y	x	x	y	y	x	x	y	y	y	y	y	y	y	y
APVid:	0	-1	1	-1	2	-1	-1	-1	-1	-1	-1	-1	-1	-1	-1	-1	-1	-1
Chamber: TRK0	TRK0	TRK1	TRK1	TRK2	TRK2	TRK2	TRK2	TRK3	B3FE	B3LF	B3FE	B3LF	B3FE	WELL	WELL	None	None	
0	0	0	0	0	0	0	0	0	0	0	0	0	0	1	-1	191	0	0
1	1	1	1	1	1	1	1	1	1	1	-1	1	1	-1	0	255	1	1
2	2	2	2	2	2	2	2	2	2	2	1	2	2	3	-1	190	2	2
3	3	3	3	3	3	3	3	3	3	3	-1	3	3	-1	2	254	3	3
4	4	4	4	4	4	4	4	4	4	4	2	4	4	5	-1	189	4	4
5	5	5	5	5	5	5	5	5	5	5	-1	5	5	-1	4	253	5	5
6	6	6	6	6	6	6	6	6	6	6	3	6	6	7	-1	188	6	6
7	7	7	7	7	7	7	7	7	7	7	-1	7	7	-1	6	252	7	7
8	8	8	8	8	8	8	8	8	8	8	4	8	8	9	-1	187	8	8
9	9	9	9	9	9	9	9	9	9	9	-1	9	9	-1	8	251	9	9
10	10	10	10	10	10	10	10	10	10	10	5	10	10	11	-1	186	10	10
11	11	11	11	11	11	11	11	11	11	11	-1	11	11	-1	10	250	11	11
12	12	12	12	12	12	12	12	12	12	12	6	12	12	13	-1	185	12	12
13	13	13	13	13	13	13	13	13	13	13	-1	13	13	-1	12	249	13	13
14	14	14	14	14	14	14	14	14	14	14	7	14	14	15	-1	184	14	14
15	15	15	15	15	15	15	15	15	15	15	-1	15	15	-1	14	248	15	15
16	16	16	16	16	16	16	16	16	16	16	8	16	16	17	-1	183	16	16
17	17	17	17	17	17	17	17	17	17	17	-1	17	17	-1	16	247	17	17
18	18	18	18	18	18	18	18	18	18	18	9	18	18	19	-1	182	18	18
19	19	19	19	19	19	19	19	19	19	19	-1	19	19	-1	18	246	19	19
20	20	20	20	20	20	20	20	20	20	20	10	20	20	21	-1	181	20	20
21	21	21	21	21	21	21	21	21	21	21	-1	21	21	-1	20	245	21	21
22	22	22	22	22	22	22	22	22	22	22	11	22	22	23	-1	180	22	22
23	23	23	23	23	23	23	23	23	23	23	-1	23	23	-1	22	244	23	23
24	24	24	24	24	24	24	24	24	24	24	12	24	24	25	-1	179	24	24
25	25	25	25	25	25	25	25	25	25	25	-1	25	25	-1	24	243	25	25
26	26	26	26	26	26	26	26	26	26	26	13	26	26	27	-1	178	26	26
27	27	27	27	27	27	27	27	27	27	27	-1	27	27	-1	26	242	27	27
28	28	28	28	28	28	28	28	28	28	28	14	28	28	29	-1	177	28	28
29	29	29	29	29	29	29	29	29	29	29	-1	29	29	-1	28	241	29	29
30	30	30	30	30	30	30	30	30	30	30	15	30	30	31	-1	176	30	30
31	31	31	31	31	31	31	31	31	31	31	-1	31	31	-1	30	240	31	31
32	32	32	32	32	32	32	32	32	32	32	16	32	32	33	-1	175	32	32
33	33	33	33	33	33	33	33	33	33	33	-1	33	33	-1	32	239	33	33
34	34	34	34	34	34	34	34	34	34	34	17	34	34	35	-1	174	34	34
35	35	35	35	35	35	35	35	35	35	35	-1	35	35	-1	34	238	35	35
36	36	36	36	36	36	36	36	36	36	36	18	36	36	37	-1	173	36	36
37	37	37	37	37	37	37	37	37	37	37	-1	37	37	-1	36	237	37	37
38	38	38	38	38	38	38	38	38	38	38	19	38	38	39	-1	172	38	38
39	39	39	39	39	39	39	39	39	39	39	-1	39	39	-1	38	236	39	39
40	40	40	40	40	40	40	40	40	40	40	20	40	40	41	-1	171	40	40
41	41	41	41	41	41	41	41	41	41	41	-1	41	41	-1	40	235	41	41
42	42	42	42	42	42	42	42	42	42	42	21	42	42	43	-1	170	42	42
43	43	43	43	43	43	43	43	43	43	43	-1	43	43	-1	42	234	43	43
44	44	44	44	44	44	44	44	44	44	44	22	44	44	45	-1	169	44	44
45	45	45	45	45	45	45	45	45	45	45	-1	45	45	-1	44	233	45	45
46	46	46	46	46	46	46	46	46	46	46	23	46	46	47	-1	168	46	46
47	47	47	47	47	47	47	47	47	47	47	-1	47	47	-1	46	232	47	47
48	48	48	48	48	48	48	48	48	48	48	24	48	48	49	-1	167	48	48
49	49	49	49	49	49	49	49	49	49	49	-1	49	49	-1	48	231	49	49
50	50	50	50	50	50	50	50	50	50	50	25	50	50	51	-1	166	50	50
51	51	51	51	51	51	51	51	51	51	51	-1	51	51	-1	50	230	51	51
52	52	52	52	52	52	52	52	52	52	52	26	52	52	53	-1	165	52	52
53	53	53	53	53	53	53	53	53	53	53	-1	53	53	-1	52	229	53	53
54	54	54	54	54	54	54	54	54	54	54	27	54	54	55	-1	164	54	54
55	55	55	55	55	55	55	55	55	55	55	-1	55	55	-1	54	228	55	55
56	56	56	56	56	56	56	56	56	56	56	28	56	56	57	-1	163	56	56
57	57	57	57	57	57	57	57	57	57	57	-1	57	57	-1	56	227	57	57
58	58	58	58	58	58	58	58	58	58	58	29	58	58	59	-1	162	58	58
59	59	59	59	59	59	59	59	59	59	59	-1	59	59	-1	58	226	59	59
60	60	60	60	60	60	60	60	60	60	60	30	60	60	61	-1	161	60	60
61	61	61	61	61	61	61	61	61	61	61	-1	61	61	-1	60	225	61	61
62	62	62	62	62	62	62	62	62	62	62	31	62	62	63	-1	160	62	62
63	63	63	63	63	63	63	63	63	63	63	-1	63	63	-1	62	224	63	63
64	64	64	64	64	64	64	64	64	64	64	32	64	64	65	-1	159	64	64
65	65	65	65	65	65	65	65	65	65	65	-1	65	65	-1	64	223	65	65
66	66	66	66	66	66	66	66	66	66	66	33	66	66	67	-1	158	66	66
67	67	67	67	67	67	67	67	67	67	67	-1	67	67	-1	66	222	67	67
68	68	68	68	68	68	68	68	68	68	68	34	68	68	69	-1	157	68	68
69	69	69	69	69	69	69	69	69	69	69	-1	69	69	-1	68	221	69	69
70	70	70	70	70	70	70	70	70	70	70	35	70	70	71	-1	156	70	70
71	71	71	71	71	71	71	71	71	71	71	-1	71	71	-1	70	220	71	71
72	72	72	72	72	72	72	72	72	72	72	36	72	72	73	-1	155	72	72
73	73	73	73	73	73	73	73	73	73	73	-1	73	73	-1	72	219	73	73
74	74	74	74	74	74	74	74	74	74	74	37	74	74	75	-1	154	74	74
75	75	75	75	75	75	75	75	75	75	75	-1	75	75	-1	74	218	75	75
76	76	76	76	76	76	76	76	76	76	76	38	76	76	77	-1	153	76	76
77	77	77	77	77	77	77	77	77	77	77	-1	77	77	-1	76	217	77	77
78	78	78	78	78	78	78	78	78	78	78	39	78	78	79	-1	152	78	78
79	79	79	79	79	79	79	79	79	79	79	-1	79	79	-1	78	216	79	79
80	80	80	80	80	80	80	80	80	80	80	40	80	80	81	-1	151	80	80
81	81	81	81	81	81	81	81	81	81	81	-1	81	81	-1	80	215	81	81
82	82	82	82	82	82	82	82	82	82	82	41	82	82	83	-1	150	82	82
83	83	83	83	83	83	83	83	83	83	83	-1	83	83	-1	82	214	83	83
84	84	84	84	84	84	84	84	84	84	84	42	84	84	85	-1	149	84	84
85	85	85	85	85	85	85	85	85	85	85	-1	85	85	-1	84	213	85	85
86	86	86	86	86	86	86	86	86	86	86	43	86	86	87	-1	148	86	86
87	87	87	87	87	87	87	87	87	87	87	-1	87	87	-1	86	212	87	87
88	88	88	88	88	88	88	88	88	88	88	44	88	88	89	-1	147	88	88
89	89	89	89	89	89	89	89	89	89	89	-1	89	89	-1	88	211	89	89
90	90	90	90	90	90	90	90	90	90	90	45	90	90	91	-1	146	90	90
91	91	91	91	91	91	91	91	91	91	91	-1	91	91	-1	90	210	91	91
92	92	92	92	92	92	92	92	92	92	92	46	92	92	93	-1	145	92	92
93	93	93	93	93	93	93	93	93	93	93	-1	93	93	-1	92	209	93	93
94	94	94	94	94	94	94	94	94	94	94	47	94	94	95	-1	144	94	94
95	95	95	95	95	95	95	95	95	95	95	-1	95	95	-1	94	208	95	95
96	96	96	96	96	96	96	96	96	96	96	48	96	96	97	-1	143	96	96
97	97	97	97	97	97	97	97	97	97	97	-1	97	97	-1	96	207	97	97
98	98	98	98	98	98	98	98	98	98	98	49	98	98	99	-1	142	98	98
99	99	99	99	99	99	99	99	99	99	99	-1	99	99	-1	98	206	99	99
100	100	100	100	100	100	100	100	100	100	100	50	100	100	101	-1	141	100	100
101	101	101	101	101	101	101	101	101	101	101	-1	101	101	-1	100	205	101	101
102	102	102	102	102	102	102	102	102	102	102	51	102	102	103	-1	140	102	102
103	103	103	103	103	103	103	103	103	103	103	-1	103	103	-1	102	204	103	103
104	104	104	104	104	104	104	104	104	104	104	52	104	104	105	-1	139	104	104
105	105	105	105	105	105	105	105	105	105	105	-1	105	105	-1	104	203	105	105
106	106	106	106	106	106	106	106	106	106	106	53	106	106	107	-1	138	106	106
107	107	107	107	107	107	107	107	107	107	107	-1	107	107	-1	106	202	107	107
108	108	108	108	108	108	108	108	108	108	108	54	108	108	109	-1	137	108	108
109	109	109	109	109	109	109	109	109	109	109	-1	109	109	-1	108	201	109	109
110	110	110	110	110	110	110	110	110	110	110	55	110	110	111	-1	136	110	110
111	111	111	111	111	111	111	111	111	111	111	-1	111	111	-1	110	200	111	111
112	112	112	112	112	112	112	112	112	112	112	56	112	112	113	-1	135	112	112
113	113	113	113	113	113	113	113	113	113	113	-1	113	113	-1	112	199	113	113
114	114	114	114	114	114	114	114	114	114	114	57	114	114	115	-1	134	114	114
115	115	115	115	115	115	115	115	115	115	115	-1	115	115	-1	114	198	115	115
116	116	116	116	116	116	116	116	116	116	116	58	116	116	117	-1	133	116	116
117	117	117	117	117	117	117	117	117	117	117	-1	117	117	-1	116	197	117	117
118	118	118	118	118	118	118	118	118	118	118	59	118	118	119	-1	132	118	118
119	119	119	119	119	119	119	119	119	119	119	-1	119	119	-1	118	196	119	119
120	120	120	120	120	120	120	120	120	120	120	60	120	120	121	-1	131	120	120
121	121	121	121	121	121	121	121	121	121	121	-1	121	121	-1	120	195	121	121
122	122	122	122	122	122	122	122	122	122	122	61	122	122	123	-1	130	122	122
123	123	123	123	123	123	123	123	123	123	123	-1	123	123	-1	122	194	123	123
124	124	124	124	124	124	124	124	124	124	124	62	124	124	125	-1	129	124	124
125	125	125	125	125	125	125	125	125	125	125	-1	125	125	-1	124	193	125	125
126	126	126	126	126	126	126	126	126	126	126	63	126	126	127	-1	128	126	126
127	127	127	127	127	127	127	127	127	127	127	-1	127	127	-1	126	192	127	127
