#mmdaq v1 mapping file for test beam JULY 2012														
#MB JW 28/7/2012
#
APVid:	3	0	1	2	7	4	5	6	11	8	9	10	15	12	13	14
Chamber:	T1	T1	T2	T2	T3	T3	T4	T4	T5	T5	T6	T6	T7	T7	T8	T8
0	33	160	33	160	33	160	33	160	33	160	33	160	33	160	33	160
1	32	159	32	159	32	159	32	159	32	159	32	159	32	159	32	159
2	34	161	34	161	34	161	34	161	34	161	34	161	34	161	34	161
3	31	158	31	158	31	158	31	158	31	158	31	158	31	158	31	158
4	35	162	35	162	35	162	35	162	35	162	35	162	35	162	35	162
5	30	157	30	157	30	157	30	157	30	157	30	157	30	157	30	157
6	36	163	36	163	36	163	36	163	36	163	36	163	36	163	36	163
7	29	156	29	156	29	156	29	156	29	156	29	156	29	156	29	156
8	37	164	37	164	37	164	37	164	37	164	37	164	37	164	37	164
9	28	155	28	155	28	155	28	155	28	155	28	155	28	155	28	155
10	38	165	38	165	38	165	38	165	38	165	38	165	38	165	38	165
11	27	154	27	154	27	154	27	154	27	154	27	154	27	154	27	154
12	39	166	39	166	39	166	39	166	39	166	39	166	39	166	39	166
13	26	153	26	153	26	153	26	153	26	153	26	153	26	153	26	153
14	40	167	40	167	40	167	40	167	40	167	40	167	40	167	40	167
15	25	152	25	152	25	152	25	152	25	152	25	152	25	152	25	152
16	41	168	41	168	41	168	41	168	41	168	41	168	41	168	41	168
17	24	151	24	151	24	151	24	151	24	151	24	151	24	151	24	151
18	42	169	42	169	42	169	42	169	42	169	42	169	42	169	42	169
19	23	150	23	150	23	150	23	150	23	150	23	150	23	150	23	150
20	43	170	43	170	43	170	43	170	43	170	43	170	43	170	43	170
21	22	149	22	149	22	149	22	149	22	149	22	149	22	149	22	149
22	44	171	44	171	44	171	44	171	44	171	44	171	44	171	44	171
23	21	148	21	148	21	148	21	148	21	148	21	148	21	148	21	148
24	45	172	45	172	45	172	45	172	45	172	45	172	45	172	45	172
25	20	147	20	147	20	147	20	147	20	147	20	147	20	147	20	147
26	46	173	46	173	46	173	46	173	46	173	46	173	46	173	46	173
27	19	146	19	146	19	146	19	146	19	146	19	146	19	146	19	146
28	47	174	47	174	47	174	47	174	47	174	47	174	47	174	47	174
29	18	145	18	145	18	145	18	145	18	145	18	145	18	145	18	145
30	48	175	48	175	48	175	48	175	48	175	48	175	48	175	48	175
31	17	144	17	144	17	144	17	144	17	144	17	144	17	144	17	144
32	49	176	49	176	49	176	49	176	49	176	49	176	49	176	49	176
33	16	143	16	143	16	143	16	143	16	143	16	143	16	143	16	143
34	50	177	50	177	50	177	50	177	50	177	50	177	50	177	50	177
35	15	142	15	142	15	142	15	142	15	142	15	142	15	142	15	142
36	51	178	51	178	51	178	51	178	51	178	51	178	51	178	51	178
37	14	141	14	141	14	141	14	141	14	141	14	141	14	141	14	141
38	52	179	52	179	52	179	52	179	52	179	52	179	52	179	52	179
39	13	140	13	140	13	140	13	140	13	140	13	140	13	140	13	140
40	53	180	53	180	53	180	53	180	53	180	53	180	53	180	53	180
41	12	139	12	139	12	139	12	139	12	139	12	139	12	139	12	139
42	54	181	54	181	54	181	54	181	54	181	54	181	54	181	54	181
43	11	138	11	138	11	138	11	138	11	138	11	138	11	138	11	138
44	55	182	55	182	55	182	55	182	55	182	55	182	55	182	55	182
45	10	137	10	137	10	137	10	137	10	137	10	137	10	137	10	137
46	56	183	56	183	56	183	56	183	56	183	56	183	56	183	56	183
47	9	136	9	136	9	136	9	136	9	136	9	136	9	136	9	136
48	57	184	57	184	57	184	57	184	57	184	57	184	57	184	57	184
49	8	135	8	135	8	135	8	135	8	135	8	135	8	135	8	135
50	58	185	58	185	58	185	58	185	58	185	58	185	58	185	58	185
51	7	134	7	134	7	134	7	134	7	134	7	134	7	134	7	134
52	59	186	59	186	59	186	59	186	59	186	59	186	59	186	59	186
53	6	133	6	133	6	133	6	133	6	133	6	133	6	133	6	133
54	60	187	60	187	60	187	60	187	60	187	60	187	60	187	60	187
55	5	132	5	132	5	132	5	132	5	132	5	132	5	132	5	132
56	61	188	61	188	61	188	61	188	61	188	61	188	61	188	61	188
57	4	131	4	131	4	131	4	131	4	131	4	131	4	131	4	131
58	62	189	62	189	62	189	62	189	62	189	62	189	62	189	62	189
59	3	130	3	130	3	130	3	130	3	130	3	130	3	130	3	130
60	63	190	63	190	63	190	63	190	63	190	63	190	63	190	63	190
61	2	129	2	129	2	129	2	129	2	129	2	129	2	129	2	129
62	64	191	64	191	64	191	64	191	64	191	64	191	64	191	64	191
63	1	256	1	256	1	256	1	256	1	256	1	256	1	256	1	256
64	65	192	65	192	65	192	65	192	65	192	65	192	65	192	65	192
65	128	255	128	255	128	255	128	255	128	255	128	255	128	255	128	255
66	66	193	66	193	66	193	66	193	66	193	66	193	66	193	66	193
67	127	254	127	254	127	254	127	254	127	254	127	254	127	254	127	254
68	67	194	67	194	67	194	67	194	67	194	67	194	67	194	67	194
69	126	253	126	253	126	253	126	253	126	253	126	253	126	253	126	253
70	68	195	68	195	68	195	68	195	68	195	68	195	68	195	68	195
71	125	252	125	252	125	252	125	252	125	252	125	252	125	252	125	252
72	69	196	69	196	69	196	69	196	69	196	69	196	69	196	69	196
73	124	251	124	251	124	251	124	251	124	251	124	251	124	251	124	251
74	70	197	70	197	70	197	70	197	70	197	70	197	70	197	70	197
75	123	250	123	250	123	250	123	250	123	250	123	250	123	250	123	250
76	71	198	71	198	71	198	71	198	71	198	71	198	71	198	71	198
77	122	249	122	249	122	249	122	249	122	249	122	249	122	249	122	249
78	72	199	72	199	72	199	72	199	72	199	72	199	72	199	72	199
79	121	248	121	248	121	248	121	248	121	248	121	248	121	248	121	248
80	73	200	73	200	73	200	73	200	73	200	73	200	73	200	73	200
81	120	247	120	247	120	247	120	247	120	247	120	247	120	247	120	247
82	74	201	74	201	74	201	74	201	74	201	74	201	74	201	74	201
83	119	246	119	246	119	246	119	246	119	246	119	246	119	246	119	246
84	75	202	75	202	75	202	75	202	75	202	75	202	75	202	75	202
85	118	245	118	245	118	245	118	245	118	245	118	245	118	245	118	245
86	76	203	76	203	76	203	76	203	76	203	76	203	76	203	76	203
87	117	244	117	244	117	244	117	244	117	244	117	244	117	244	117	244
88	77	204	77	204	77	204	77	204	77	204	77	204	77	204	77	204
89	116	243	116	243	116	243	116	243	116	243	116	243	116	243	116	243
90	78	205	78	205	78	205	78	205	78	205	78	205	78	205	78	205
91	115	242	115	242	115	242	115	242	115	242	115	242	115	242	115	242
92	79	206	79	206	79	206	79	206	79	206	79	206	79	206	79	206
93	114	241	114	241	114	241	114	241	114	241	114	241	114	241	114	241
94	80	207	80	207	80	207	80	207	80	207	80	207	80	207	80	207
95	113	240	113	240	113	240	113	240	113	240	113	240	113	240	113	240
96	81	208	81	208	81	208	81	208	81	208	81	208	81	208	81	208
97	112	239	112	239	112	239	112	239	112	239	112	239	112	239	112	239
98	82	209	82	209	82	209	82	209	82	209	82	209	82	209	82	209
99	111	238	111	238	111	238	111	238	111	238	111	238	111	238	111	238
100	83	210	83	210	83	210	83	210	83	210	83	210	83	210	83	210
101	110	237	110	237	110	237	110	237	110	237	110	237	110	237	110	237
102	84	211	84	211	84	211	84	211	84	211	84	211	84	211	84	211
103	109	236	109	236	109	236	109	236	109	236	109	236	109	236	109	236
104	85	212	85	212	85	212	85	212	85	212	85	212	85	212	85	212
105	108	235	108	235	108	235	108	235	108	235	108	235	108	235	108	235
106	86	213	86	213	86	213	86	213	86	213	86	213	86	213	86	213
107	107	234	107	234	107	234	107	234	107	234	107	234	107	234	107	234
108	87	214	87	214	87	214	87	214	87	214	87	214	87	214	87	214
109	106	233	106	233	106	233	106	233	106	233	106	233	106	233	106	233
110	88	215	88	215	88	215	88	215	88	215	88	215	88	215	88	215
111	105	232	105	232	105	232	105	232	105	232	105	232	105	232	105	232
112	89	216	89	216	89	216	89	216	89	216	89	216	89	216	89	216
113	104	231	104	231	104	231	104	231	104	231	104	231	104	231	104	231
114	90	217	90	217	90	217	90	217	90	217	90	217	90	217	90	217
115	103	230	103	230	103	230	103	230	103	230	103	230	103	230	103	230
116	91	218	91	218	91	218	91	218	91	218	91	218	91	218	91	218
117	102	229	102	229	102	229	102	229	102	229	102	229	102	229	102	229
118	92	219	92	219	92	219	92	219	92	219	92	219	92	219	92	219
119	101	228	101	228	101	228	101	228	101	228	101	228	101	228	101	228
120	93	220	93	220	93	220	93	220	93	220	93	220	93	220	93	220
121	100	227	100	227	100	227	100	227	100	227	100	227	100	227	100	227
122	94	221	94	221	94	221	94	221	94	221	94	221	94	221	94	221
123	99	226	99	226	99	226	99	226	99	226	99	226	99	226	99	226
124	95	222	95	222	95	222	95	222	95	222	95	222	95	222	95	222
125	98	225	98	225	98	225	98	225	98	225	98	225	98	225	98	225
126	96	223	96	223	96	223	96	223	96	223	96	223	96	223	96	223
127	97	224	97	224	97	224	97	224	97	224	97	224	97	224	97	224

